####################
#$...........$$#...#
#$##$##$##$##$##.#.#
#........@.......#.#
##################.#
#$$$$$E............#
####################