##########
#..~....E#
#.######.#
#...M.K#.#
#......#.#
#.....M#~#
#......#.#
#@.......#
##########