###########
#.$$$E$$$.#
#.$#$.$#$.#
#.$$$.$$$.#
#@#######K#
#.$$$.$$$.#
#.$#$.$#$.#
#.$$$.$$$.#
###########